1111111111111
10010000000C1
10000111110V1
1P0011E000001
1001110000001
1111111111111