1111111111111111111111111111111111111111111111111
10P0000000000000000000000000000000000000000000001
1001110001110001110001110011100001110011100111001
1001110001110001110001110011100001110011100111001
1001110001110001110001110011100001110011100111001
1000000000000000C00000000000000000000000000000001
10000000000000000000000000000000000000000000E0001
1000000000000000000000C00000000000000000000000001
1001110001110001110001110011100001110011100111001
1001110001110001110001110011100001110011100111001
1001110001110001110001110011100001110011100111001
1000000000000000000000000000000000000000000000001
1000000000000000000000000000000000000000000000001
1001110001110001110001110011100001110011100111001
1001110001110001110001110011100001110011100111001
1001110001110001110001110011100001110011100111001
1000000000000000000000000000000000000000000000001
1111111111111111111111111111111111111111111111111