111111111111111111111111111111111111111111111
100000000000011000000000111111111111111000001
100000000000111000000000111111111111111000001
10000P0E0001111000000000000000000001111000001
100000000011111000000000000000000000000000001
100000000110011000000000000000000000000000001
100000001100011000000000000000000001111000001
100000011000011000000000111111111111111000001
100000110000011000000000111111111111111000001
100001100000011000000000111111111111111000001
100011000000011000000000111100000000000000001
1001111111111110000000001111000CCC00000000001
1000000000000110000000001111000CCC00000000001
100000000000000000000000111100000000000000001
100000000000000000000000111111111111111000001
100000000000011000000000111111111111111000001
100000000000011000000000111111111111111000001
111111111111111111111111111111111111111111111