1111111111111111111111111111111111111111111111111111111111111111
1000000010000000000000000000000000000000000001000C00000000000001
1000CC0010000000000000000000000000000000000001000000000000000001
10111111100000000000000000000000CE000000000001000000000000000001
1000000000000000000000000000000000000000000001000000000000000001
1000000000000000000000000000000000000000000001000000000000000001
1000000000000000000001111111111110000000000001100000000000000001
1000000000000000000001111111111110000000000001100000000000000001
1000000000000000000001111111111110000000000001100000000000000001
1000000000000000000000000000000000000000000000000000000000000001
1000000000000000000000000000000000000000000000000000000000000001
1000000000000000000001111111111110000000000001100000000000000001
1000000000000000000001111111111110000000000001100000000000000001
1000000000000000000001111111111110000000000001100000000000000001
1000000000000000000000000000000000000000000000000000000000000001
1000000000000000000000000000P00000000000000000000000000000000001
1000000000000000000000000000000000000000000000000000000000000001
1000000010000000000000000000000000000000000001CCCC00000000000001
1000000010000000000000000000000000000000000000000000000000000001
10000000100000000000000000CCCCC000000000000001000000000000000001
1000000010000000000001111111111110000000000001100000000000000001
1000000010000000000001111111111110000000000001100000000000000001
1000000010000000000001111111111110000000000001100000000000000001
1000000010000000000000000000000000000000000000000000000000000001
1000000C10000000000000000000000000000000000001000000000000000001
1111111111111111111111111111111111111111111111111111111111111111