1111111
1P10001
10000C1
10000E1
1000001
10000C1
101V001
1111111